Pip Bloom - School
Snoh Aalegra - Sometimes
j'san - alone by your side
xJK. - haHAA
kasper x mowley - when ur gone
iamalex - 1998
Pale Grey - Seasons
Tennis - I Miss That Feeling
Simon Jefferis - Shades
Abe M Beats - Trampoline//3:45 A.M.
93 Bulls - Denim Pockets
King Gizzard and the Lizard Wizard - Countdown
Mudhoney - Good Enough
Raindrop - Only Hope
Pip Blom - Babies Are A Lie
saib. - Serenade
Dirty Art Club - Sugar
Alvvays - Pimsoll Punks
Ross From Friends - Romeo, Romeo
Azad - Enough of You (Karnaval Blues Remix)
Ducktails - Map to the Stars
Kedr Livanskiy - Love and Cigarettes
Prima - June Gloom
Alvvays - Dreams Tonite
Corbin - Ice Boy
DUCKWRTH - BOY
Bemos - 12:34 AM
Slyme - Suicide Doors
Kedr Livanskiy - Ariadna
Sobs - Girl
Palehound - If you met her
Alvvays - In Undertow
iamalex - Together
Bare Pales - Tasteless
Animal Husbandry - The Good Times are Killing Me
GRIGOR - Nostalgia for places you have never been to
Cabbage - Gibraltar Ape
iamalex - I Forgot How To Fly
Alex G - Bobby
Holy Now - Dead End
Fazerdaze - Lucky Girl
DJ Seinfeld - Forget U
Bernache - Your Name
Sweet William - My Connection
Blosson . The Kills - Hula Dancer
Homeshake - Khmlwugh
Deejay Astral - Let You Go
Sofi TUKKER - Johnny
Killer Bee - luvsick
Mac DeMarco - Special K
Invention - E n d u r a n c e
Yared Kiflai - CGH
93 Bulls - Silver Lining
chinese food - yesterday


