Stand by Your Man - Tammy Wynette
He Stopped Loving Her Today - George Jones
Crazy - Patsy Cline . Willie Nelson
Ring of Fire - Johnny Cash
Your Cheatin' Heart - Hank Williams
Friends in Low Places - Garth Brooks
I Fall to Pieces - Patsy Cline
Galveston - Glen Campbell
Behind Closed Doors - Charlie Rich
Mommas Don't Let Your Babies Grow Up to Be Cowboys - Waylon Jennings . Willie Nelson
Blue Moon of Kentucky - Bill Monroe
Amarillo by Morning - George Strait
Coal Miner's Daughter - Loretta Lynn
The Dance - Garth Brooks
Forever and Ever, Amen - Randy Travis
I Will Always Love You - Dolly Parton
Hello Darlin - Conway Twitty
Country Roads - John Denver
Hey Good Lookin - Hank Williams
I Am a Man of Constant Sorrow - Foggy Bottom Boys
Okie from Muskogee - Merle Haggard
Wide Open Spaces - Dixie Chicks
Blue Eyes Crying in the Rain - Willie Nelson
The Chair - George Strait
Folsom Prison Blues - Johnny Cash
The Gambler - Kenny Rogers
Fancy - Reba McEntire
Where Were You (When the World Stopped Turning) - Alan Jackson
I'm So Lonesome I Could Cry - Hank Williams Sr.
I Hope You Dance - Lee Ann Womack
I Walk the Line - Johnny Cash
Rhinestone Cowboy - Glen Campbell
Always on My Mind - Willie Nelson
Harper Valley PTA - Jeannie C. Riley
D-I-V-O-R-C-E - Tammy Wynette
Will the Circle be Unbroken - Carter Family, Nitty Gritty Dirt Band
King of the Road - Roger Miller
Breathe - Faith Hill
Make the World Go Away - Eddy Arnold
Hello Walls - Faron Young
Sweet Dreams - Patsy Cline
El Paso - Marty Robbins
Delta Dawn - Tanya Tucker
When I Call Your Name - Vince Gill
Guitars, Cadillacs - Dwight Yoakam
Desperado - The Eagles
Don't Come Home A Drinkin' - Loretta Lynn
Boot Scootin' Boogie - Brooks . Dunn
I Can't Stop Loving You - Ray Charles
Independence Day - Martina McBride
It Wasn't God Who Made Honky Tonk Angels - Kitty Wells
On the Other Hand - Randy Travis
Walking the Floor Over You - Ernest Tubb
Coat of Many Colors - Dolly Parton
Act Naturally - Buck Owens
Mama He's Crazy - The Judds
If You've Got the Money, I've Got the Time - Lefty Frizzell
Kiss an Angel Good Morning - Charlie Pride
Family Tradition - Hank Williams Jr.
Go Rest High on That Mountain - Vince Gill
Lovesick Blues - Hank Williams
Don't Rock the Jukebox - Alan Jackson
Tennessee Waltz - Patty Page
When You Say Nothing at All - Alison Krauss
God Bless the USA - Lee Greenwood
Green, Green Grass of Home - Porter Wagoner
It's Your Love - Tim McGraw . Faith Hill
There Stands the Glass - Webb Pierce
Devil Went Down to Georgia - Charlie Daniels
Chiseled in Stone - Vern Gosdin
Don't Toss Us Away - Patty Loveless
A Boy Named Sue - Johnny Cash
You Are My Sunshine - Gov. Jimmy Davis
Flowers on the Wall - Statler Brothers
Strawberry Wine - Deana Carter
Good Hearted Woman - Waylon Jennings
You're Still the One - Shania Twain
My Home's in Alabama - Alabama
Is There Life Out There - Reba McEntire
She's in Love With the Boy - Trisha Yearwood
Smoky Mountain Rain - Ronnie Milsap
Should've Been a Cowboy - Toby Keith
Rose Garden - Lynn Anderson
Please Remember Me - Tim McGraw
Blue - LeAnn Rimes
Before the Next Teardrop Falls - Freddie Fender
Passionate Kisses - Mary Chapin Carpenter
Have I Told You Lately That I Love You - Gene Autry
Here's a Quarter - Travis Tritt
He'll Have to Go - Jim Reeves
Seven Year Ache - Rosanne Cash
Sunday Morning Coming Down - Johnny Cash . Kris Kristofferson
Take this Job and Shove It - Johnny PayCheck
Something in Red - Lorrie Morgan
Foggy Mountain Breakdown - Flatt . Scruggs
I'd Be Better Off in a Pine Box - Doug Stone
Amazed - Lonestar
Faded Love - Bob Wills
Back in the Saddle Again - Gene Autry
Killin' Time - Clint Black