A Song Of Fire and Ice (Sarah Stone Vocal Edit) - Just A Gent
A Thousand Times - Trolley Snatcha
Around The Block (Datsik Remix) - Pretty Lights . Talib Kweli . Datsik
Bad Boy Flow (Protohype Dubstep VIP) - Protohype . ETC!ETC!
Beam (Skrux Remix) - MakO . Angel Taylor . Skrux
Before I Fall - Zanski . Ibe
Blow Your Speakers - Filth Collins
Bring The Rain (AFK Remix) - Candyland . AFK 
Bring the Rain (heRobust remix) - Candyland . heRobust
Candy - Zanski . Bombs . Bottles
Catch Me As I Fall (Koa Remix) - Melissa Pixel . Koa
Chainsaw (Direktor Remix) - Prostecutioner . Direktor
Chasing Ghosts - Collin McLoughlin
Chemicals - Rekoil
Chiaroscuro (Vaski Remix) - Sound Remedy . Vaski 
Chiaroscuro - Sound Remedy
Cobra - Vaski
Coolest Cat - Cyran
Deze - JVN
Diamond Sky (Skrux Remix) - Elliot Berger . Laura Brehm . Skrux
Dope Arcade (MitiS Remix) - Ascension . MitiS
Fathom - Frequent
Find You (PRFFTT . Svyable Remix) - Skrux . Felxprod . PRFFTT . Svyable
For This Moment - Spag Heddy
For You - Killabyte
Fragments (Clark Kent Remix) - Jaymes Young . Clark Kent
Fuck Trap - Kurfew
Game On - Timeline
Get Wild (MUST DIE! Remix) - Candyland . MUST DIE!
Gonna Move - Karetus
Good Fella - EXPLQIT
Grinder - Walka
Gunshot - ChooKy
Hand Trigga - Bobby Duque . Mr. Welch
Hanging On (Myriad Remix) - Thallie Ann Seenyen . Myriad
Heavy - Filthzilla
Home (RoughMath Remix) - Jarvis . Ivy Jayne . RoughMath
Home (SirensCeol Remix) - Jarvis . Ivy Jayne . SirensCeol
Humanity - Phasmo
Hypnotizing (Vocal VIP) - SPL
If U Feel - Spag Heddy
Implode - Subtex
Kabuki - Tisoki
Knockout - Tisoki
Lawless - Pegboard Nerds
Lift Me - Inaki
Lights Out - Getter
Lucid - Bryzone
Medieval Dub VIP - Dub Scout
Mellow - PADU
Mercurial - Anna Yvette
Minions - KromeEdge
Misery - Crystal Drop
Molly's Song - Beyond Ominous
Moments (Ennui Remix) - Mutrix . Charity Vance . Vena Cava . Ennui 
Mr. French - Mantis
Mushroom Factory - Panda Eyes
Nightmare - SirensCeol . Sean Dee
Nobody Cares - Dub Bangers . EH!DE
Nosebleed - Jarvis
One Desire - Collin McLoughlin 
Only You (Darphesh Remix) - Tisoki . Shoshki . Darphesh
Open Your Eyes - Case and Point . Lara Woolf
Pandora - REDNEK
Papa Smurf's Evening Riddim - Obscenity
Perfect Timing (Stick Up Kids) - Figure
Phantom - Des McMahon
Phoenix - Elim . Mitchell Leighton
Planet Online (Culprate Remix) - Neosignal . Culprate
Renegade - David Butterfield
Roots (I AM ROBOT Remix) - Mashur . Kevlar . I AM ROBOT
Run - Secoya
Shooting Star - Collin McLoughlin
Shout Me! - Dorris . Lady Killa . Sweeney
Sine Time - Spag Heddy
Skeleton Key (RUN DMT Remix) - Love Inks . RUN DMT
Standing On A Hill - Flux Pavilion
Stardust Redux (Crywolf Remix) - Minnesota . Crywolf
Stethoscope (Squidthief Remix) - Dub Scout . Squidthief
Stinger (Spag Heddy Remix) - Oliver Heldens . Spag Heddy
Stratos - Stabby . Poizon
Sunrise - HiLo
Surveillance Society - TRUTH
Swashbuckle - LoBounce . Flinch
Take Me Away - Melodies Influencing Actions
Tangent - Labrat . Downsquarez . Jamburglar
The Art of Rise and Fall - Castor Troy
The Traveller - Warriyo
The Wolf (Tetrix Bass Remix) - Felxprod . Thallie Ann Seenyen . Tetrix Bass
The Wolf - Felxprod . Thallie Ann Seenyen
Trigger - Kezwik . Mel Presson
Undercover (Dilemn Remix) - Bluescreens . Dilemn
Unlimited Pancakes - SirensCeol
Voices - Urbanstep
We Are - PRFFTT . Svyable . Crywolf
When The Light Shines - M-one . Ngaire Blackman
Wicked (Jantsen Remix) - Karetus . Clinton Sly . Jantsen
Wut - THE UN1K
Ye Olde - Cyran
Your Addiction Duelle (Panda Eyes Remix) - CiRRO . Panda Eyes
