HUMBLE (Skrillex Remix) - Kendrick Lamar . Skrillex
Faded - Rickyxsan
Era - RL Grime
WAWA - Party Favor
U R So Fucked (RIOT Remix) - Infected Mushroom . RIOT
Silence (Slushii Remix) - Khalid . Marshmello . Slushii
The Killer - NGHTMRE . Bret James . RNSOM
Buns - Wax Motif . Wuki . Earlly Mac
Wolves - Marshmello . Selena Gomez
Damn Damn Damn - Denis Phenomen . Potrykus
Sick - Soltan . HU$H
Rake it Up (Diplo . Party Remix) - Yo Gotti . Nicki Minaj . Diplo
Forgotten - KRANE . Graves
Fight - Choppa Dunks
Do You Like Bass? - Yellow Claw . Juyen Subulba
Pineapple (G Jones Remix) - Eprom . G Jones
Insane - Rickyxsan
Lean Back (NGHTMRE Remix) - Terror Squad . NGHTMRE
From the Back - Out of Cookies
Stranger - DISKORD
Want U - DISKORD
Get With the Program - Zomboy . O.V
Next World - KRANE . Quix
Dem Fraid (Ray Volpe Remix) - Taranchyla . Boombox Cartel . Roy Volpe
DJ Turn It Up - Yellow Claw
Error - Leotrix
Say Less (Eptic Remix) - G-Eazy . Dillon Francis . Eptic
Big Man General (UNKWN Remix) - Fabian Mazur . UNKWN
On The Run - NGHTMRE . Passeport
Limitless - Sam F . Sophie Rose
Badam - Mr. Vegas . Hardwell
Lit - T-Pain . Gucci Mane . Steve Aoki
Drop it Down Low (BrainDeaD Remix) - Richie Loop . Henry Fong . BrainDeaD
Core - RL Grime
Jefe - Boombox Cartel
Jefe (Rickyxsan Remix) - Boombox Cartel . Rickyxsan
Let Me Love You (Marshmello Remix) - Marshmello . DJ Snake . Justin Bieber
You and Me (Flume Remix) - Disclosure . Eliza Doolittle . Flume
Purple Lamborghini - Rick Ross . Skrillex
Jungle Juice - Vlien Boy . Mages
Silence (Illenium Remix) - Marshmello . Khalid . Illenium
Dem Fraid - Taranchyla . Boombox Cartel
Scylla - RL Grime
Propaganda - DJ Snake
Light - San Holo
Duality - TYNAN  